11111111111111111111111111
11111111100000000000000001
10000000110000000001000001
10000000110000000001000001
10000P00010000000000000001
10000000000000000000000001
10000000000000000000000001
10000000000001000000000001
10000000000010000000000001
10000000000011000000000001
10000000000111100000000001
11111111111111111111111111